resUMSProjectTitle=نظام ادارة المستخدمين
resUMSMenuSettingsTitle=الأعدادات
resUMSLogoutTitle=خروج
resUMSMenuDashboardTitle=لوحة المعلومات
resUMSMenuGeneralTitle=عام
resUMSMenuOperationsTitle=العمليات
resUMSMenuDelegationsTitle=التفويض
resUMSMenuDepartmentsTitle=الأقسام
resUMSMenuDepartmentsPositionsTitle=مناصب الأقسام
resUMSMenuDepartmentsResponsibilitiesTitle=مسؤوليات الأقسام
resUMSMenuDepartmentsContactsTitle=جهات الأقسام
resUMSMenuDepartmentsNotesTitle=ملاحظات الأقسام
resUMSMenuDepartmentsAttachmentsTitle=مرفقات الأقسام
resUMSMenuRolesTitle=الأدوار
resUMSMenuRolesPositionsTitle=مناصب الأدوار
resUMSMenuRolesResponsibilitiesTitle=مسؤوليات الادوار
resUMSMenuRolesContactsTitle=جهات الأدوار
resUMSMenuRolesNotesTitle=ملاحظات الأدوار
resUMSMenuRolesAttachmentsTitle=مرفقات الأدوار
resUMSMenuPositionsTitle=المناصب
resUMSMenuPositionsResponsibilitiesTitle=مسؤوليات المناصب
resUMSMenuPositionsContactsTitle=جهات المناصب
resUMSMenuPositionsNotesTitle=ملاحظات المناصب
resUMSMenuPositionsAttachmentsTitle=مرفقات المناصب
resUMSMenuPrivilagesTitle=الصلاحيات
resUMSMenuUsersPrivilagesTitle=صلاحيات المستخدمين
resUMSMenuPositionsPrivilagesTitle=صلاحيات المناصب
resUMSMenuRolesPrivilagesTitle=صلاحيات الأدوار
resUMSMenuUsersProfilesTitle=ملفات المستخدمين
resUMSMenuUsersPositionsTitle=مناصب المستخدمين
resUMSMenuUsersContactsTitle=جهات المستخدمين
resUMSMenuUsersNotesTitle=ملاحظات المستخدمين
resUMSMenuUsersAttachmentsTitle=مرفقات المستخدمين
resUMSMenuProfilesAttachmentsTitle=مرفقات ملفات المستخدمين
resUMSMenuUsersTitle=المستخدمين
resUMSCopyright=الحقوق محفوظة ل
resUMSPaggingFirstTitle=الأول
resUMSPaggingNextTitle=التالي
resUMSPaggingPrivTitle=السابق
resUMSPaggingLastTitle=الأخير
resUMSCreateButtonTitle=انشاء
resUMSCancelButtonTitle=خروج
resUMSCreateNewItemButtonTitle=انشاء عنصر جديد
resUMSActionOptionsTitle=خيارات
resUMSActionOptionsDetailsTitle=عرض التفاصيل
resUMSActionOptionsEditTitle=تعديل
resUMSActionOptionsDeleteTitle=حذف
resUMSLoadingProgressTitle=الرجاء الأنتظار ...
resUMSNewButtonTitle=جديد
resUMSTableColumnName=الأسم
resUMSTableColumnPassword=كلمة المرور
resUMSTableColumnDefaultPosition=المنصب الأفتراضي
resUMSTableColumnNote=ملاحظة
resUMSTableColumnLastLogin=اخر دخول
resUMSTableColumnFlags=علام
resUMSTableColumnBlocked=حظر
resUMSTableColumnActions=الأجراءات
resUMSTableColumnSearch=البحث في 
resUMSGeneralSearchTitle=ابحث ...
resUMSPaggingNotFoundDataAvariable=لا يوجد بيانات متاحة في الجدول
resUMSPaggingNotFoundDataMatched=لا يوجد بيانات متطابقة في الجدول