resUMSProjectTitle=K-User Managment System
resUMSMenuSettingsTitle=Settings
resUMSLogoutTitle=Logout
resUMSMenuDashboardTitle=Dashboard
resUMSMenuGeneralTitle=General
resUMSMenuOperationsTitle=Operations
resUMSMenuDelegationsTitle=Delegations
resUMSMenuDepartmentsTitle=Departments
resUMSMenuDepartmentsPositionsTitle=Departments Positions
resUMSMenuDepartmentsResponsibilitiesTitle=Departments Responsibilities
resUMSMenuDepartmentsContactsTitle=Departments Contacts
resUMSMenuDepartmentsNotesTitle=Departments Notes
resUMSMenuDepartmentsAttachmentsTitle=Departments Attachments
resUMSMenuRolesTitle=Roles
resUMSMenuRolesPositionsTitle=Roles Positions
resUMSMenuRolesResponsibilitiesTitle=Roles Responsibilities
resUMSMenuRolesContactsTitle=Roles Contacts
resUMSMenuRolesNotesTitle=Roles Notes
resUMSMenuRolesAttachmentsTitle=Roles Attachments
resUMSMenuPositionsTitle=Positions
resUMSMenuPositionsResponsibilitiesTitle=Positions Responsibilities
resUMSMenuPositionsContactsTitle=Positions Contacts
resUMSMenuPositionsNotesTitle=Positions Notes
resUMSMenuPositionsAttachmentsTitle=Positions Attachments
resUMSMenuPrivilagesTitle=Privilages
resUMSMenuUsersPrivilagesTitle=Users Privilages
resUMSMenuPositionsPrivilagesTitle=Positions Privilages
resUMSMenuRolesPrivilagesTitle=Roles Privilages
resUMSMenuUsersProfilesTitle=Users Profiles
resUMSMenuUsersPositionsTitle=Users Positions
resUMSMenuUsersContactsTitle=Users Contacts
resUMSMenuUsersNotesTitle=Users Notes
resUMSMenuUsersAttachmentsTitle=Users Attachments
resUMSMenuProfilesAttachmentsTitle=Profiles Attachments
resUMSMenuUsersTitle=Users
resUMSCopyright=Copyright
resUMSPaggingFirstTitle=First
resUMSPaggingNextTitle=Next
resUMSPaggingPrivTitle=Priv
resUMSPaggingLastTitle=Last
resUMSCreateButtonTitle=Create
resUMSCancelButtonTitle=Cancel
resUMSCreateNewItemButtonTitle=Create New Item
resUMSActionOptionsTitle=Options
resUMSActionOptionsDetailsTitle=Details
resUMSActionOptionsEditTitle=Edit
resUMSActionOptionsDeleteTitle=Delete
resUMSLoadingProgressTitle=Please Wait ...
resUMSNewButtonTitle=New
resUMSTableColumnName=Name
resUMSTableColumnPassword=Password
resUMSTableColumnDefaultPosition=Default Position
resUMSTableColumnNote=Note
resUMSTableColumnLastLogin=LastLogin
resUMSTableColumnFlags=Flags
resUMSTableColumnBlocked=Blocked
resUMSTableColumnActions=Actions
resUMSTableColumnSearch=Search in
resUMSGeneralSearchTitle=Search ...
resUMSPaggingNotFoundDataAvariable=Not found data avariable in table
resUMSPaggingNotFoundDataMatched=Not found data matched in table